33
#################################
# #       #   #     #           #
# # #           ##  #  #  # #   #
# #  ######  # #         #   #  #
# #  #   ## ## ###### #### ##   #
#   #A   #       #   #     #    #
# #       ##  ##     ##   ###  ##
# ##     # ###  #     # #  #    #
#   ######     #  ##   #   #    #
#   #   #####  ######  #  #     #
# #####   #          #### #  ####
#   #   ##  #### #  #  T#       #
#     #  #   #   #  #     #     #
#    ##   ##  #   #  #  ##  #####
### #  #      #    #  #         #
#   #       #   #        #      #
#################################
