11
###########
#         #
#  A      #
#         #
#       T #
#         #
###########