17
#################
#A              #
#   ###         #
#     ######### #
#  ##   ### T   #
#   #  ##       #
#               #
#################