33
#################################
# #       #   #     #           #
# # #           ##  #  #  # #   #
# #  ######  # #         #   #  #
# #  #   ## ## ###### #### ##   #
#   A    #       #   #     #    #
# #       ##  ##     ##   ###  ##
# #      # ###  #     # #  #    #
#  #######     #  ##   #   #    #
#              ######  #  #     #
#                    #### #  ####
#                      T#       #
#                         #     #
#    ##   ##  #   #  #  ##  #####
### #  #      #    #  #         #
#   #       #   #        #      #
#################################
